1 2 1 2 1 2 1 2 1 2 29 8 35 36 15 15 15 15 15 15 15 15 15 15 31 31 31 31 31 15 15 16 16 15 16 32 32 16 16 15 15 15 16 16 16 32 32 32 32 32 15 16 16 16 32 32 32 31 32 16 16 16 16 16 16 16 16 16 16 16 16 16 16 15 16 16 16 16 16 16 
17 18 17 18 17 18 17 18 17 18 23 24 51 52 31 31 31 31 31 31 31 15 16 16 15 16 16 16 15 16 15 15 15 15 15 16 15 15 15 15 16 16 15 16 16 32 16 15 16 16 16 32 32 32 31 31 32 16 32 15 16 16 16 16 32 32 32 32 32 32 32 32 32 16 16 15 16 16 16 16 
1 2 1 2 1 2 1 2 1 2 29 8 35 36 15 16 16 16 16 16 16 16 15 16 16 16 15 15 15 15 15 31 15 16 15 15 31 15 16 15 16 16 15 15 15 16 16 15 15 15 15 15 16 31 32 32 32 32 16 16 32 32 32 32 15 16 16 31 31 32 32 15 16 16 16 16 15 15 16 32 
17 18 17 18 17 18 17 18 17 18 23 24 51 52 15 16 32 16 32 15 15 15 16 15 15 15 31 31 31 15 16 15 15 15 15 16 16 16 15 15 15 15 15 16 16 16 32 31 15 16 16 16 16 32 32 32 16 32 32 32 31 32 16 16 16 32 32 16 15 16 16 15 15 15 15 15 15 16 16 32 
1 2 1 2 1 2 1 2 1 2 29 8 35 36 15 16 32 32 15 15 15 15 15 31 15 16 16 15 31 15 15 31 15 16 15 15 15 15 31 15 16 16 16 16 32 32 15 16 16 16 32 32 32 32 32 32 32 31 31 32 32 32 32 32 32 31 31 32 16 15 15 31 31 31 15 16 16 16 32 32 
17 18 17 18 17 18 17 18 17 18 23 24 51 52 15 16 15 15 31 15 31 31 31 32 15 15 15 31 32 31 31 32 15 15 16 16 16 16 16 16 16 32 32 32 15 15 15 15 15 15 16 15 15 31 31 32 32 32 15 15 15 31 31 32 32 32 31 31 32 15 16 16 16 16 16 32 32 16 31 32 
1 2 1 2 1 2 1 2 1 2 29 8 35 36 15 15 31 15 15 31 15 16 16 16 16 16 16 16 16 16 16 16 16 16 16 32 32 32 32 32 32 16 16 16 16 16 16 16 16 16 16 15 31 32 15 15 15 16 31 31 31 32 15 31 31 32 16 16 16 16 32 32 32 32 32 31 32 32 16 32 
17 18 17 18 17 18 17 18 17 18 23 24 51 15 31 15 15 31 31 32 31 32 32 32 32 32 32 32 32 32 32 32 32 32 32 16 32 32 32 32 32 32 32 32 32 32 32 32 32 15 15 15 15 15 31 31 15 15 15 16 31 31 31 32 32 32 32 32 15 15 15 16 31 31 31 32 32 32 32 32 
1 2 1 2 1 2 1 2 1 2 29 8 35 31 31 31 31 31 32 32 31 31 31 32 15 16 16 16 16 16 16 32 32 32 32 15 15 15 15 15 15 15 15 15 16 15 15 15 15 31 31 31 31 31 31 32 31 31 15 15 15 15 15 15 15 15 111 112 129 130 141 142 141 142 141 142 141 142 141 142 
17 18 17 18 17 161 162 18 17 18 23 24 51 52 15 15 15 15 16 32 16 16 16 16 16 16 32 32 32 15 16 16 16 15 15 31 31 31 31 31 31 31 31 31 15 15 31 169 170 31 32 31 31 15 16 16 16 16 16 31 31 31 31 31 31 31 127 128 145 146 157 158 157 158 157 158 157 158 157 158 
1 2 1 2 1 177 178 2 1 2 29 8 11 12 15 31 31 15 15 15 15 15 15 15 15 15 15 15 15 31 32 32 32 31 31 31 32 16 16 16 16 16 16 15 31 31 31 185 186 16 16 16 16 31 32 32 32 32 15 31 32 16 16 16 16 16 107 108 109 110 77 78 75 76 77 78 75 76 77 78 
17 18 143 144 17 18 17 18 17 18 23 24 27 28 31 31 32 31 31 31 31 31 31 31 31 31 31 31 31 31 31 31 31 31 32 32 32 32 32 32 32 32 32 31 31 32 32 32 32 32 32 32 32 32 32 32 32 32 31 31 32 32 32 32 32 32 123 124 125 126 93 94 91 92 93 94 91 92 93 94 
1 2 159 160 1 2 1 2 1 2 3 4 13 14 33 34 33 34 33 34 33 34 33 34 33 33 33 33 33 33 33 33 33 33 33 34 33 34 33 34 33 34 33 34 33 33 33 33 33 34 33 33 33 34 33 34 33 34 33 34 33 34 33 34 33 34 79 80 105 106 69 70 69 70 69 70 69 70 69 70 
17 18 17 18 17 18 17 18 17 18 19 20 29 30 49 50 49 50 49 50 49 50 49 50 49 49 49 49 49 49 49 49 49 49 49 50 49 50 49 50 49 50 49 50 49 49 49 49 49 50 49 49 49 50 49 50 49 50 49 50 49 50 49 50 49 50 95 96 121 122 85 86 85 86 85 86 85 86 85 86 
1 2 1 2 1 2 1 2 1 2 3 4 1 2 1 2 1 2 1 2 1 2 1 2 1 2 1 2 1 2 1 2 1 2 1 2 1 2 1 2 1 2 1 2 1 2 1 2 1 2 1 2 1 2 1 2 1 2 1 2 1 2 1 2 1 2 79 80 133 134 135 136 135 136 135 136 135 136 135 136 
17 18 17 18 17 18 17 18 17 18 19 20 17 18 17 18 17 18 17 18 17 18 17 18 17 18 17 18 17 18 17 18 17 18 17 18 17 18 17 18 17 18 17 18 17 18 17 18 17 18 17 18 17 18 17 18 17 18 17 18 17 18 17 18 17 18 95 96 149 150 151 152 151 152 151 152 151 152 271 272 
1 2 1 2 1 143 144 2 1 2 3 4 1 2 1 2 1 2 1 2 1 2 1 2 1 2 1 2 1 2 1 2 1 2 1 2 1 2 1 2 1 2 1 2 1 2 1 2 1 2 1 2 1 2 1 2 1 2 1 2 1 2 1 2 1 2 79 80 97 98 117 118 117 118 117 118 117 118 287 288 
17 18 17 18 17 159 160 18 17 18 19 20 17 18 17 18 17 18 17 18 17 18 17 18 17 18 17 18 17 18 17 18 17 18 17 18 17 18 17 18 17 18 17 18 17 18 17 18 17 18 17 18 17 18 17 18 17 18 17 18 17 18 17 18 17 18 95 96 97 98 101 102 101 102 101 102 101 102 101 102 
1 2 1 2 1 2 1 2 1 2 3 4 1 2 1 2 1 2 1 2 1 2 1 2 1 2 1 2 1 2 1 2 1 2 1 2 1 2 1 2 1 2 1 2 1 2 1 2 1 2 1 2 1 2 1 2 1 2 1 2 1 2 1 2 1 2 79 80 97 98 117 118 117 118 117 118 117 118 117 118 
17 18 17 18 17 18 17 18 17 18 19 20 17 18 17 18 17 18 17 18 17 18 161 162 17 18 17 18 17 18 17 18 17 18 17 18 17 18 17 18 17 18 17 161 162 18 17 18 17 18 17 18 17 18 17 18 17 18 17 18 17 18 17 18 17 18 95 96 97 98 101 102 101 102 101 102 289 290 291 292 
1 2 1 2 1 2 1 2 1 2 3 4 1 2 1 2 1 2 1 2 1 2 177 178 1 2 1 2 1 2 1 2 1 2 1 2 1 2 1 2 1 2 1 177 178 2 1 2 1 2 1 2 1 2 1 2 1 2 1 2 1 2 1 2 171 172 173 174 175 176 193 118 117 118 117 118 305 306 307 308 
17 18 17 18 17 18 17 18 17 18 19 20 17 18 17 18 17 18 17 18 17 18 17 18 17 18 17 18 17 18 17 18 17 18 17 18 17 18 17 18 17 18 17 177 178 18 17 18 17 18 17 18 17 18 17 18 17 18 17 18 17 18 17 18 187 188 189 190 191 192 209 102 101 102 101 102 101 102 101 102 
1 2 1 2 1 2 1 2 1 2 3 4 1 2 1 2 1 2 1 2 1 2 1 2 1 2 1 2 1 2 1 2 1 2 1 2 1 2 1 2 1 2 1 2 1 2 1 2 1 2 1 2 1 2 1 2 1 2 1 2 1 2 1 2 195 196 197 198 199 200 201 118 117 118 117 118 117 118 117 118 
17 18 17 18 17 18 17 5 6 18 19 20 17 18 17 18 17 18 17 18 17 18 17 18 17 18 17 18 17 18 17 18 17 18 17 143 144 18 17 18 17 18 17 18 17 18 17 18 17 18 17 18 17 18 17 18 17 18 17 18 17 18 17 18 211 212 213 214 215 216 217 102 101 102 101 102 101 102 101 102 
1 2 1 2 1 2 1 21 22 2 3 4 1 2 1 2 1 2 1 2 1 2 1 2 1 2 1 2 1 2 1 2 1 2 1 159 160 2 1 2 1 2 1 2 1 2 1 2 1 2 1 2 1 2 1 2 1 2 1 2 1 2 1 2 203 204 205 206 207 208 225 118 117 118 117 118 117 118 117 118 
17 18 17 161 162 18 17 18 17 18 19 20 17 18 17 18 17 18 17 18 17 18 17 18 17 18 17 18 17 18 17 18 17 18 17 18 17 18 17 18 17 18 17 18 17 18 17 18 17 18 17 18 17 18 17 18 17 18 17 18 17 18 17 18 219 220 221 222 223 224 241 102 101 102 269 270 101 102 101 102 
1 2 1 177 178 2 1 2 5 6 3 4 1 2 1 2 1 2 1 2 1 2 1 2 1 2 1 2 1 2 1 2 1 2 1 2 1 2 1 2 1 2 1 2 1 2 1 2 1 2 1 2 1 2 1 2 1 2 1 2 1 2 1 2 227 228 229 230 231 232 233 102 101 102 285 286 101 102 101 102 
17 18 17 18 17 18 17 18 21 22 19 20 17 18 17 18 17 18 17 18 17 18 17 18 17 18 17 18 17 18 17 18 17 18 17 18 17 18 17 18 17 18 17 18 17 18 17 18 17 18 17 18 17 18 17 18 17 18 17 18 17 18 17 18 243 244 245 246 247 248 249 118 117 118 117 118 117 118 117 118 
1 2 1 2 1 2 1 2 1 2 3 4 1 2 1 2 1 2 1 2 1 2 1 2 1 2 1 2 1 2 1 2 1 2 1 2 1 2 1 2 1 2 1 2 1 2 1 2 1 2 1 2 1 2 1 2 1 2 1 2 1 2 1 2 235 236 237 238 239 240 257 102 101 102 101 102 101 102 101 102 
17 18 17 18 17 18 17 18 17 18 19 20 17 18 17 18 17 18 17 18 17 18 17 18 17 18 143 144 17 18 17 18 17 18 17 18 17 18 17 18 17 18 17 18 17 18 17 18 17 18 17 18 17 18 17 18 17 18 17 18 17 18 17 18 251 252 253 254 255 256 273 118 117 118 117 118 117 118 117 118 
1 2 1 2 1 2 1 2 1 2 3 4 1 2 1 2 1 2 1 2 1 2 1 2 1 2 159 160 1 2 1 2 1 2 1 2 1 2 1 2 1 2 1 2 1 2 1 2 1 2 1 2 1 2 1 2 1 2 1 2 1 2 1 2 259 260 261 262 265 266 263 102 101 102 101 102 101 269 270 102 
17 18 17 18 17 18 17 161 162 18 19 20 17 18 17 18 17 18 17 18 17 18 17 18 17 18 17 18 17 18 17 161 162 18 17 18 17 18 17 18 17 18 17 18 17 18 17 18 17 18 17 18 17 18 17 18 17 18 17 18 17 18 17 18 17 18 95 96 97 98 117 118 117 118 117 118 117 285 286 118 
1 2 1 2 1 2 1 177 178 2 3 4 1 2 1 2 1 2 1 2 1 2 1 2 1 2 1 2 1 2 1 177 178 2 1 2 1 2 1 2 1 2 1 2 1 2 1 2 1 2 1 2 1 2 1 2 1 2 1 2 1 2 1 2 1 2 79 80 97 98 101 102 101 102 101 102 101 102 101 102 
17 18 17 297 298 18 17 18 17 18 19 20 17 18 17 18 17 18 17 18 17 18 17 18 17 18 17 18 17 18 17 18 17 18 17 18 17 18 17 18 17 18 17 18 17 18 17 18 17 18 17 18 17 18 17 18 17 18 17 18 17 18 17 18 17 18 95 96 97 98 117 118 117 118 117 118 117 118 117 118 
1 2 1 313 314 2 1 2 1 2 3 4 1 2 1 2 1 2 1 2 1 2 1 2 1 2 1 2 1 2 1 2 1 2 1 2 1 2 1 2 1 2 1 2 1 2 1 2 1 2 1 2 1 2 1 2 1 2 1 2 1 2 1 2 1 2 79 80 97 98 101 102 101 102 101 102 101 102 101 102 
17 18 17 18 17 18 17 18 17 18 19 20 17 18 17 18 17 18 17 18 17 18 17 18 17 18 17 18 17 18 17 18 17 18 17 18 17 18 17 18 17 18 17 18 17 18 17 18 17 18 17 18 17 18 17 18 17 18 17 18 17 18 17 18 17 18 95 96 97 98 117 118 117 118 117 118 117 118 117 118 
1 2 1 2 1 2 1 2 1 2 3 4 1 2 1 2 1 2 1 2 1 2 1 2 1 2 1 2 1 2 1 2 1 2 1 2 1 2 1 2 1 2 1 2 1 2 1 2 1 2 1 2 1 2 1 2 1 2 1 2 1 2 1 2 1 2 79 80 97 98 101 102 101 102 101 102 101 102 101 102 
17 18 17 18 17 18 17 18 17 18 19 20 17 18 17 18 17 18 17 18 17 18 17 18 17 18 17 18 17 18 17 18 17 18 143 144 17 18 17 18 17 18 17 18 17 18 17 18 17 18 17 18 17 18 161 162 17 18 17 18 17 18 17 18 17 18 95 96 97 98 101 102 271 272 101 102 101 102 101 102 
1 2 299 300 1 2 1 2 1 2 3 4 1 2 1 2 1 2 1 2 1 2 1 2 1 2 1 2 1 2 1 2 1 2 159 143 144 2 1 2 1 2 1 2 1 2 1 2 1 2 1 2 1 2 177 178 1 2 1 2 1 2 1 2 1 2 79 80 97 98 117 118 287 288 117 118 117 118 117 118 
17 18 315 316 17 18 17 18 17 18 19 20 17 18 17 18 17 18 17 18 17 18 17 143 144 18 17 18 17 18 17 18 17 18 17 159 160 18 17 18 17 18 17 18 17 18 17 18 17 18 17 18 17 18 177 178 17 18 17 18 17 18 17 18 171 172 173 174 175 176 193 194 101 102 101 102 101 102 101 102 
1 2 1 2 1 2 1 2 1 2 3 4 1 2 1 2 1 2 1 2 1 2 1 159 160 2 1 2 1 2 1 2 1 2 1 2 1 2 1 2 1 2 1 2 1 2 1 2 1 2 1 2 1 2 1 2 1 2 1 2 1 2 1 2 187 188 189 190 191 192 209 210 117 118 117 118 117 118 117 118 
17 18 143 144 17 18 17 18 17 18 19 20 17 18 17 18 17 18 17 18 17 18 17 18 17 18 17 18 17 18 17 18 17 18 17 18 17 18 17 18 17 18 17 18 17 18 17 18 17 18 17 18 17 18 17 18 17 18 17 18 17 18 17 18 195 196 197 198 199 200 201 102 101 102 101 102 101 102 101 102 
1 2 143 144 1 2 1 2 1 2 3 4 1 2 1 2 1 2 1 2 1 2 1 2 1 2 1 2 1 2 1 2 1 2 1 2 1 2 1 2 1 2 1 2 1 2 1 2 1 2 1 2 1 2 1 2 1 2 1 2 1 2 1 2 211 212 213 214 215 216 217 118 117 118 117 118 117 118 117 118 
17 18 159 160 17 18 17 18 17 18 19 20 17 18 17 18 17 18 17 18 17 18 17 18 17 18 17 18 17 18 17 18 17 18 17 18 17 18 17 18 17 18 17 18 17 18 17 143 144 18 17 18 17 18 17 18 17 18 17 18 17 18 17 18 203 204 205 206 207 208 225 226 101 102 101 102 101 102 101 102 
1 2 1 2 1 2 1 2 1 2 3 4 1 2 1 2 1 2 1 2 1 2 1 2 1 2 1 2 1 2 1 2 1 2 1 2 1 2 1 2 1 2 1 2 1 2 1 159 160 2 1 2 1 2 1 2 1 2 1 2 1 2 1 2 219 220 221 222 223 224 241 242 117 118 117 118 117 118 117 118 
17 18 17 18 17 18 17 18 17 18 19 20 17 18 17 18 17 18 17 18 17 18 17 18 17 18 17 18 17 18 17 18 17 18 17 18 17 18 161 162 17 18 17 18 17 18 17 18 17 18 17 18 17 18 17 18 17 18 17 18 17 18 17 18 227 228 229 230 231 232 233 258 101 102 101 102 101 102 101 102 
1 2 1 5 6 2 1 2 1 2 3 4 1 2 1 2 1 2 1 2 1 2 1 2 1 2 1 2 1 2 1 2 1 2 1 2 1 2 177 178 1 2 1 2 1 2 1 2 1 2 1 2 1 2 1 2 1 2 1 2 1 2 1 2 243 244 245 246 247 248 249 274 117 118 117 118 117 118 117 118 
17 18 17 21 22 18 17 18 17 18 19 20 17 18 17 18 17 18 17 18 17 18 17 18 17 18 17 18 17 18 17 18 17 18 17 18 17 18 17 18 17 18 17 18 17 18 17 18 17 18 17 18 17 18 17 18 17 18 17 18 17 18 17 18 235 236 237 238 239 240 257 258 101 102 101 102 101 102 101 102 
1 2 1 2 1 2 1 2 1 2 3 4 1 2 1 2 1 2 1 2 1 161 161 162 1 2 1 2 1 2 1 2 1 2 1 2 1 2 1 2 1 2 1 2 1 2 1 2 1 2 1 2 1 2 1 2 1 2 1 2 1 2 1 2 251 252 253 254 255 256 273 274 101 102 101 102 101 102 101 102 
17 18 17 18 17 18 17 18 17 18 19 20 17 18 17 18 17 18 17 18 17 177 177 178 17 18 17 18 17 18 17 18 17 18 17 18 17 18 17 18 17 18 17 18 17 18 17 18 17 18 17 18 17 18 17 18 17 18 17 18 17 18 17 18 259 260 261 262 265 266 263 264 117 118 269 270 117 118 117 118 
1 2 1 2 1 2 1 2 1 2 3 4 1 2 1 2 1 2 1 2 1 2 1 2 1 2 1 2 1 2 1 2 1 2 1 2 1 2 1 2 1 2 1 2 1 2 1 2 1 2 1 2 1 2 1 2 1 2 1 2 1 2 1 2 275 276 277 278 281 282 279 280 101 102 285 286 101 102 101 102 
17 18 17 18 17 161 162 18 17 18 19 20 17 18 17 18 17 18 17 18 17 18 17 18 17 18 17 18 17 18 17 18 17 18 17 18 17 18 17 18 17 18 17 18 17 18 17 18 17 161 162 18 17 18 17 18 17 18 17 18 17 18 17 18 17 18 95 96 97 98 117 293 294 295 296 118 117 118 117 118 
1 2 1 2 1 177 178 2 1 2 3 4 1 2 1 2 1 2 1 2 1 2 1 2 1 2 1 2 1 2 1 2 1 2 1 2 1 2 1 2 1 2 1 2 1 2 1 2 1 177 178 2 1 2 1 2 1 2 1 2 1 2 1 2 1 2 79 80 97 98 101 309 310 311 312 102 101 102 101 102 
17 18 17 18 17 18 17 18 17 18 19 20 17 18 17 18 17 18 17 18 17 18 17 18 17 18 17 18 17 18 17 18 17 18 17 18 17 18 17 18 17 18 17 18 17 18 17 18 17 18 17 18 17 18 17 18 17 18 17 18 17 18 17 18 17 18 95 96 97 98 117 118 117 118 117 118 117 118 117 118 
1 2 1 2 1 2 1 2 1 2 3 4 1 2 1 2 1 2 1 2 1 2 1 2 1 2 1 2 1 2 1 2 1 2 1 2 1 2 1 2 1 2 1 2 1 2 1 2 1 2 1 2 1 2 1 2 1 2 1 2 1 2 1 2 1 2 79 80 97 98 101 271 272 102 101 102 101 102 101 102 
17 18 17 18 17 18 17 18 17 18 19 20 17 18 17 18 17 18 17 18 17 18 17 18 17 18 17 18 17 18 17 18 17 18 17 18 17 18 17 18 17 18 17 18 17 18 17 18 17 18 17 18 17 18 17 18 17 18 17 18 17 18 17 18 17 18 95 96 97 98 117 287 288 118 117 118 117 118 117 118 
1 2 143 144 144 2 1 2 1 2 3 4 1 2 1 2 1 2 1 2 1 2 1 2 1 2 1 2 1 2 1 2 1 2 1 2 1 2 1 2 1 2 1 2 1 2 1 2 1 2 1 2 1 2 1 2 1 2 1 2 1 2 1 2 1 2 79 80 97 98 101 102 101 102 101 102 271 272 101 102 
17 18 159 160 160 18 17 18 17 18 19 20 17 18 17 18 17 18 17 18 17 18 17 18 17 18 17 18 17 18 17 18 17 18 17 18 17 18 17 18 17 18 17 18 17 18 17 18 17 18 17 18 17 18 17 18 17 18 17 18 17 18 17 18 17 18 95 96 97 98 117 118 117 118 117 118 287 288 117 118 
1 2 1 2 1 2 1 2 1 2 3 4 1 2 1 2 1 2 1 2 1 2 1 2 1 2 1 2 1 2 1 2 1 2 1 2 1 2 143 144 1 2 1 2 1 2 1 2 1 2 1 2 1 2 1 2 1 2 1 2 1 2 1 2 1 2 41 42 97 98 101 102 101 102 101 102 101 102 101 102 
17 18 17 18 17 18 17 18 17 18 19 20 17 18 17 18 17 18 17 18 17 18 17 18 161 162 17 18 17 18 17 18 17 18 17 18 17 18 159 160 17 18 17 18 17 18 17 18 17 18 17 18 17 18 17 18 17 18 17 18 143 144 17 18 17 18 57 58 113 114 115 116 115 116 115 116 115 116 115 116 
1 2 1 2 163 164 1 2 1 2 3 4 1 2 1 2 1 2 1 2 1 2 1 2 177 178 1 2 1 2 1 2 1 2 1 2 1 2 1 2 1 2 1 2 1 2 1 2 1 2 1 2 1 2 1 2 1 2 1 2 159 160 1 2 1 2 41 42 65 66 73 74 73 74 73 74 73 74 73 74 
17 18 17 18 179 180 17 18 17 18 19 20 17 18 17 18 17 18 17 18 17 18 17 18 17 18 17 18 17 18 17 18 17 18 17 18 17 18 17 18 17 18 17 18 17 18 17 18 17 18 17 18 17 18 17 18 17 18 17 18 17 18 17 18 17 18 57 58 81 82 89 90 89 90 89 90 89 90 89 90 
1 2 1 2 1 2 1 2 1 2 3 4 1 2 1 2 1 2 1 2 1 2 1 2 1 2 1 2 1 2 1 2 1 2 1 2 1 2 1 2 1 2 1 2 1 2 1 2 1 2 1 2 1 2 1 2 1 2 1 2 1 2 1 2 1 2 43 44 67 68 77 78 77 78 77 78 77 78 77 78 
17 18 17 18 17 18 17 18 17 18 19 20 17 18 17 18 17 18 17 18 17 18 17 18 17 18 17 18 17 18 17 18 17 18 17 18 17 18 17 18 17 18 17 18 17 18 17 18 17 18 17 18 17 18 17 18 17 18 17 18 17 18 17 18 17 18 59 60 83 84 93 94 93 94 93 94 93 94 93 94 
1 2 1 2 1 2 1 2 1 2 3 4 1 2 1 2 1 2 1 2 1 2 1 2 1 2 1 2 1 2 1 2 1 2 1 2 1 2 1 2 1 2 1 2 1 2 1 2 1 2 1 2 1 2 1 2 1 2 1 2 1 2 1 2 1 2 45 46 69 70 69 70 69 70 69 70 69 70 69 70 
17 18 17 18 17 18 17 18 17 18 19 20 17 18 17 18 17 18 17 18 17 18 17 18 17 18 17 18 17 18 17 18 17 18 17 18 17 18 17 18 17 18 17 18 17 18 17 18 17 18 17 18 17 18 17 18 17 18 17 18 17 18 17 18 17 18 61 62 85 86 85 86 85 86 85 86 85 86 85 86 
1 2 1 2 1 2 1 2 1 2 3 4 37 38 37 38 37 38 37 38 37 38 37 38 37 38 37 38 37 38 37 38 37 37 37 38 37 38 37 38 37 38 37 37 37 37 37 38 37 37 37 37 37 38 37 38 37 38 37 38 37 38 37 38 37 38 47 48 71 72 71 72 71 72 71 72 71 72 71 72 
17 18 17 18 161 162 17 18 17 18 19 20 53 54 53 54 53 54 53 54 53 54 53 54 53 54 53 54 53 54 53 54 53 53 53 54 53 54 53 54 53 54 53 53 53 53 53 54 53 53 53 53 53 54 53 54 53 54 53 54 53 54 53 54 53 54 63 64 87 88 87 88 87 88 87 88 87 88 87 88 
1 2 1 2 177 178 1 2 1 2 3 4 39 40 39 40 39 40 39 40 39 40 39 40 39 40 39 40 39 40 39 40 39 39 39 40 39 40 39 40 39 40 39 39 39 39 39 40 39 39 39 39 39 40 39 40 39 40 39 40 39 40 39 40 39 40 39 40 39 39 39 39 39 40 39 40 39 39 39 40 
17 18 17 18 17 18 17 18 17 18 19 20 55 56 55 56 55 56 55 56 55 56 55 56 55 56 55 56 55 56 55 56 55 55 55 56 55 56 55 56 55 56 55 55 55 55 55 56 55 55 55 55 55 56 55 56 55 56 55 56 55 56 55 56 55 56 55 56 55 55 55 55 55 56 55 56 55 55 55 56 
1 2 1 2 1 2 1 2 1 2 3 4 1 2 1 2 1 2 1 2 1 2 1 2 1 2 1 2 1 2 1 303 304 2 1 2 1 2 1 2 1 2 1 2 1 2 1 165 166 2 1 2 1 2 1 2 1 2 1 2 1 2 1 2 1 2 1 2 1 2 1 2 1 2 1 2 1 2 303 304 
17 18 17 18 17 18 17 18 17 18 19 20 17 18 17 18 17 18 17 18 17 18 17 18 17 18 17 18 17 18 17 319 320 18 17 18 17 18 17 18 17 18 17 18 17 18 17 181 182 18 17 18 17 18 17 18 17 18 17 18 17 18 17 18 17 18 17 18 17 18 17 18 17 18 17 18 17 18 319 320 
1 2 1 2 1 2 1 2 1 2 3 4 1 2 1 2 1 2 1 2 1 2 1 2 1 2 1 2 1 2 143 144 1 2 1 2 1 2 1 2 167 168 1 2 1 2 1 2 1 2 1 2 1 2 1 2 1 2 1 2 1 2 1 2 1 2 1 2 1 2 1 2 1 2 1 2 1 2 1 2 
17 18 17 18 17 18 17 18 17 18 19 20 17 18 17 18 17 18 17 18 161 162 17 18 17 18 17 18 17 18 159 160 17 18 17 18 17 18 17 18 183 184 17 18 17 18 17 18 17 18 17 18 17 18 17 18 17 18 17 18 17 143 144 18 17 18 17 18 17 18 17 18 17 18 5 6 17 18 17 18 
1 2 1 2 1 2 5 6 1 2 3 4 1 2 1 2 1 2 1 2 177 178 1 2 1 2 1 2 1 2 1 2 1 2 1 2 1 2 1 2 1 2 1 2 1 2 1 2 1 2 1 2 1 2 1 2 163 164 1 2 1 159 160 2 1 2 1 301 302 2 1 2 1 2 21 22 297 298 1 2 
17 18 17 18 17 18 21 22 17 18 19 20 17 18 17 18 17 18 17 18 17 18 17 18 17 18 17 18 17 18 17 18 17 18 143 144 17 18 17 18 17 18 17 18 17 18 17 18 17 18 17 18 17 18 17 18 179 180 17 18 17 18 17 18 17 18 17 317 318 18 17 18 17 18 17 18 313 314 17 18 
1 2 1 2 1 2 1 2 1 2 3 4 1 2 299 300 1 2 1 167 168 2 1 2 1 2 1 2 1 2 1 2 5 6 159 160 1 2 1 2 1 2 1 2 1 2 1 2 1 2 1 2 1 2 1 2 1 2 1 2 1 2 143 144 1 2 1 2 1 2 1 2 1 2 1 2 1 2 1 2 
17 18 17 18 297 298 17 18 17 18 19 20 17 18 315 316 17 18 17 183 184 18 17 18 17 18 17 18 17 18 17 18 21 22 17 18 17 18 17 18 17 297 298 18 17 18 161 162 17 18 17 18 17 18 17 18 17 18 17 18 17 18 159 160 17 18 17 18 17 18 17 167 168 18 17 18 17 18 17 18 
1 2 1 2 313 314 1 2 1 2 3 4 1 2 1 2 1 2 1 2 1 2 1 2 1 2 1 2 1 2 1 2 1 2 1 2 1 2 301 302 1 313 314 2 1 2 177 178 1 2 1 2 1 2 1 2 1 2 1 2 1 2 299 300 1 2 1 2 1 2 1 183 184 2 1 2 1 2 1 2 
17 18 17 18 17 18 17 18 17 18 19 20 17 18 17 18 17 18 17 18 17 18 17 18 17 18 17 18 17 18 17 18 17 18 17 18 17 18 317 318 17 18 17 18 17 18 17 18 17 18 17 18 17 18 17 18 17 18 17 18 17 18 315 316 17 18 17 18 17 18 17 18 17 18 17 18 17 18 17 18